<map>
00000000000111010101110000000000000000000000000000000004400400400000000000000000000000000000000000000000000000000000000000000000000000000000000000000000000000000000000000000000000000000000
00000000000100011101010000000000000000000000000000004400000400400000009900000000000000000000000000000000000000000000000000000000000000000000000000000000000000000000000000000000000000000000
00000000000111010101010000000000000000020000000000004400000444400000009999000000000000000000000000000000000000000000000000000000000000000000000000000000000000000000000000000000000000000000
00000000000000000000000000000000000000000000000000000044000400400000090000900000000000000000000000000000000000000000000000000000000000000000000000000000000000000000000000000000000000000000
00000000000000000000000000000000000000000000000000000000000400400000900000090000000000000000000000000000000000000000000000000000000000000000000000000000000000000000000000000000000000000000
00000000000000000000000000000000000000000101010101000000000000000000000000000000000000000000000000000000000000000000000000000000000000000000000000000000000000000000000000000000000000000000
00000000000000000000000000000000000000000100000001000000000000000000000000000000000000000000000000000000000000000000000000000000000000000000000000000000000000000001000000000000000000000000
01010101010101010101010101010101022412010100000001010101010101010101010112000001010101010101010101011201000101010101010101010101011200000001010101010101010101120101111111111111111100000000
00000000000000000000000000000000000000000000000000000000000000000000000001000001000000000000000000000001040100000000000000000000000100000001000000000000000000000000000000000000000000000000
00000000000000000000000000000000000000000000000000000000000000000000000001000001000000000000000000000001010100000000000000000000000104040401000000000000000000000000000000000000000000000000
00000000000000000000000000000000000000000000000000000000000000000000000001010101000000000000000000000000000000000000000000000000000101010101000000000000000000000000000000000000000000000000
00000000000000000000000000000000000000000000000000000000000000000000000000000000000000000000000000000000000000000000000000000000000000000000000000000000000000000000000000000000000000000000
00000000000000000000000000000000000000000000000000000000000000000000000000000000000000000000000000000000000000000000000000000000000000000000000000000000000000000000000000000000000000000000
00000000000000000000000000000000000000000000000000000000000000000000000000000000000000000000000000000000000000000000000000000000000000000000000000000000000000000000000000000000000000000000
</map>
<tip>
Made by Charles Van Huele
</tip>
